залпом-ананас.mp3
health - 10
...@....
1.......
...1....
1.......
......2.
....2...
1.......
...1....
1.......
......2.
....2...
1.......
...1....
1.......
......2.
....2...
1.......
...1....
1.......
......2.
....2...
